高峰	高峰
什么	什麼
讲下	講吓
回流	回流
迴流	回流
公厘	公厘
厘米	厘米
汇总	匯總
开户 開戶
周常	週常
编制	編製 編制
墨卡托	墨卡托
里卡多	里卡多
里克	里克
里奇	里奇
里佐	里佐
里德	里德
里斯	里斯
马里诺	馬里諾
莫里森	莫里森
哈里斯	哈里斯
埃里克森	艾瑞克森
罗德里格斯	羅德里格斯
克里斯蒂安森	克里斯蒂安森
凯里	凱里
加里	蓋瑞
拉里	拉里
特里	崔
克里斯	克里斯
德里克	德里克
埃里克	艾瑞克
哈里森	哈里森
艾德里安	艾德里安
帕特里克	派崔克
克里斯蒂安	克里斯蒂安
克里斯蒂夫	克里斯蒂夫
克里斯蒂娜	克里斯蒂娜
托鲁斯	托魯斯
安的列斯群岛	安地列斯群島
斯堪的纳维亚	斯堪地那維亞
的里雅斯特	的里雅斯特
埃弗里	埃弗里
塔兰托	塔蘭托
里基特	里基特
克罗托内	克羅托內
诺曼底	諾曼第
马里	馬利
代夫特	代爾夫特
郁郁不得志	鬱鬱不得志
发霉	發霉
倒霉	倒霉
倒大霉	倒大霉
杏干	杏乾
草莓干	草莓乾
无花果干	無花果乾
帝王历	帝王曆
恺撒	凱撒
尝一口	嚐一口
混账	混帳
松个绑	鬆个綁
狄俄斯库里	狄俄斯庫里
布拉干萨	布拉干薩
里阿	里阿
